level,masc,fem,total,uf,mes,ano,var
Consultas psicológicas,736,300,1036,ac,dez,2014,cons
Consultas psicológicas,212,0,212,ac,jun,2014,cons
Consultas psicológicas,918,3,921,ac,dez,2015,cons
Consultas psicológicas,214,15,229,ac,dez,2016,cons
Consultas psicológicas,317,6,323,ac,jun,2016,cons
Consultas psicológicas,1248,12,1260,ac,dez,2017,cons
Consultas psicológicas,2501,0,2501,ac,jun,2017,cons
Consultas psicológicas,860,2,862,ac,dez,2018,cons
Consultas psicológicas,649,1,650,ac,jun,2018,cons
Consultas psicológicas,641,1,642,ac,dez,2019,cons
Consultas psicológicas,536,2,538,ac,jun,2019,cons
Consultas psicológicas,489,23,512,ac,dez,2020,cons
Consultas psicológicas,307,0,307,ac,jun,2020,cons
Consultas psicológicas,2144,0,2144,al,dez,2014,cons
Consultas psicológicas,4584,937,5521,al,jun,2014,cons
Consultas psicológicas,8538,741,9279,al,dez,2015,cons
Consultas psicológicas,4270,38,4308,al,dez,2016,cons
Consultas psicológicas,3753,455,4208,al,jun,2016,cons
Consultas psicológicas,4585,310,4895,al,dez,2017,cons
Consultas psicológicas,4426,57,4483,al,jun,2017,cons
Consultas psicológicas,3530,144,3674,al,dez,2018,cons
Consultas psicológicas,3608,429,4037,al,jun,2018,cons
Consultas psicológicas,5083,337,5420,al,dez,2019,cons
Consultas psicológicas,5006,278,5284,al,jun,2019,cons
Consultas psicológicas,6095,172,6267,al,dez,2020,cons
Consultas psicológicas,3346,115,3461,al,jun,2020,cons
Consultas psicológicas,8085,304,8389,am,dez,2014,cons
Consultas psicológicas,8109,300,8409,am,jun,2014,cons
Consultas psicológicas,11128,396,11524,am,dez,2015,cons
Consultas psicológicas,4994,538,5532,am,dez,2016,cons
Consultas psicológicas,5672,428,6100,am,jun,2016,cons
Consultas psicológicas,3702,1449,5151,am,dez,2017,cons
Consultas psicológicas,7451,400,7851,am,jun,2017,cons
Consultas psicológicas,3444,962,4406,am,dez,2018,cons
Consultas psicológicas,4581,652,5233,am,jun,2018,cons
Consultas psicológicas,7763,1701,9464,am,dez,2019,cons
Consultas psicológicas,4090,1060,5150,am,jun,2019,cons
Consultas psicológicas,20693,2429,23122,am,dez,2020,cons
Consultas psicológicas,8770,668,9438,am,jun,2020,cons
Consultas psicológicas,563,291,854,ap,dez,2014,cons
Consultas psicológicas,284,236,520,ap,jun,2014,cons
Consultas psicológicas,84,393,477,ap,dez,2015,cons
Consultas psicológicas,8,0,8,ap,dez,2016,cons
Consultas psicológicas,41,30,71,ap,jun,2016,cons
Consultas psicológicas,14,229,243,ap,dez,2017,cons
Consultas psicológicas,8,158,166,ap,jun,2017,cons
Consultas psicológicas,29,184,213,ap,dez,2018,cons
Consultas psicológicas,35,196,231,ap,jun,2018,cons
Consultas psicológicas,21,198,219,ap,dez,2019,cons
Consultas psicológicas,24,185,209,ap,jun,2019,cons
Consultas psicológicas,1114,0,1114,ap,dez,2020,cons
Consultas psicológicas,20,33,53,ap,jun,2020,cons
Consultas psicológicas,13279,766,14045,ba,dez,2014,cons
Consultas psicológicas,10287,860,11147,ba,jun,2014,cons
Consultas psicológicas,22052,2833,24885,ba,dez,2015,cons
Consultas psicológicas,10459,1107,11566,ba,dez,2016,cons
Consultas psicológicas,13353,1410,14763,ba,jun,2016,cons
Consultas psicológicas,12335,1075,13410,ba,dez,2017,cons
Consultas psicológicas,12053,1105,13158,ba,jun,2017,cons
Consultas psicológicas,16579,1626,18205,ba,dez,2018,cons
Consultas psicológicas,14158,1550,15708,ba,jun,2018,cons
Consultas psicológicas,21988,2230,24218,ba,dez,2019,cons
Consultas psicológicas,20393,1770,22163,ba,jun,2019,cons
Consultas psicológicas,15768,1462,17230,ba,dez,2020,cons
Consultas psicológicas,12050,1145,13195,ba,jun,2020,cons
Consultas psicológicas,3707,898,4605,ce,dez,2014,cons
Consultas psicológicas,1190,0,1190,ce,jun,2014,cons
Consultas psicológicas,13011,212,13223,ce,dez,2015,cons
Consultas psicológicas,7932,594,8526,ce,dez,2016,cons
Consultas psicológicas,4009,238,4247,ce,jun,2016,cons
Consultas psicológicas,3868,229,4097,ce,dez,2017,cons
Consultas psicológicas,5260,326,5586,ce,jun,2017,cons
Consultas psicológicas,11587,364,11951,ce,dez,2018,cons
Consultas psicológicas,12800,457,13257,ce,jun,2018,cons
Consultas psicológicas,15270,1391,16661,ce,dez,2019,cons
Consultas psicológicas,17035,765,17800,ce,jun,2019,cons
Consultas psicológicas,18125,2456,20581,ce,dez,2020,cons
Consultas psicológicas,20307,1438,21745,ce,jun,2020,cons
Consultas psicológicas,1772,465,2237,df,dez,2014,cons
Consultas psicológicas,2093,632,2725,df,jun,2014,cons
Consultas psicológicas,3101,1397,4498,df,dez,2015,cons
Consultas psicológicas,3862,357,4219,df,dez,2016,cons
Consultas psicológicas,1507,428,1935,df,jun,2016,cons
Consultas psicológicas,2736,720,3456,df,dez,2017,cons
Consultas psicológicas,2837,725,3562,df,jun,2017,cons
Consultas psicológicas,2157,208,2365,df,dez,2018,cons
Consultas psicológicas,2328,410,2738,df,jun,2018,cons
Consultas psicológicas,3048,567,3615,df,dez,2019,cons
Consultas psicológicas,3211,413,3624,df,jun,2019,cons
Consultas psicológicas,2251,548,2799,df,dez,2020,cons
Consultas psicológicas,3437,508,3945,df,jun,2020,cons
Consultas psicológicas,19278,4096,23374,es,dez,2014,cons
Consultas psicológicas,14418,3427,17845,es,jun,2014,cons
Consultas psicológicas,9795,2764,12559,es,dez,2015,cons
Consultas psicológicas,13451,1893,15344,es,dez,2016,cons
Consultas psicológicas,7892,1601,9493,es,jun,2016,cons
Consultas psicológicas,13381,1215,14596,es,dez,2017,cons
Consultas psicológicas,13697,1904,15601,es,jun,2017,cons
Consultas psicológicas,15587,1660,17247,es,dez,2018,cons
Consultas psicológicas,13277,974,14251,es,jun,2018,cons
Consultas psicológicas,16498,2156,18654,es,dez,2019,cons
Consultas psicológicas,17908,2511,20419,es,jun,2019,cons
Consultas psicológicas,12727,1810,14537,es,dez,2020,cons
Consultas psicológicas,9561,1214,10775,es,jun,2020,cons
Consultas psicológicas,2023,398,2421,go,dez,2014,cons
Consultas psicológicas,1470,249,1719,go,jun,2014,cons
Consultas psicológicas,1360,195,1555,go,dez,2015,cons
Consultas psicológicas,1027,267,1294,go,dez,2016,cons
Consultas psicológicas,1161,192,1353,go,jun,2016,cons
Consultas psicológicas,2499,362,2861,go,dez,2017,cons
Consultas psicológicas,1131,98,1229,go,jun,2017,cons
Consultas psicológicas,3704,884,4588,go,dez,2018,cons
Consultas psicológicas,2061,304,2365,go,jun,2018,cons
Consultas psicológicas,3613,294,3907,go,dez,2019,cons
Consultas psicológicas,3813,197,4010,go,jun,2019,cons
Consultas psicológicas,4830,421,5251,go,dez,2020,cons
Consultas psicológicas,5146,264,5410,go,jun,2020,cons
Consultas psicológicas,1079,174,1253,ma,dez,2014,cons
Consultas psicológicas,3786,268,4054,ma,jun,2014,cons
Consultas psicológicas,2047,157,2204,ma,dez,2015,cons
Consultas psicológicas,4913,446,5359,ma,dez,2016,cons
Consultas psicológicas,2482,133,2615,ma,jun,2016,cons
Consultas psicológicas,0,0,0,ma,dez,2017,cons
Consultas psicológicas,0,0,0,ma,jun,2017,cons
Consultas psicológicas,0,0,0,ma,dez,2018,cons
Consultas psicológicas,0,0,0,ma,jun,2018,cons
Consultas psicológicas,26270,698,26968,ma,dez,2019,cons
Consultas psicológicas,0,0,0,ma,jun,2019,cons
Consultas psicológicas,22118,899,23017,ma,dez,2020,cons
Consultas psicológicas,28570,894,29464,ma,jun,2020,cons
Consultas psicológicas,39184,5478,44662,mg,dez,2014,cons
Consultas psicológicas,35974,5248,41222,mg,jun,2014,cons
Consultas psicológicas,70019,11085,81104,mg,dez,2015,cons
Consultas psicológicas,47498,4779,52277,mg,dez,2016,cons
Consultas psicológicas,37963,4585,42548,mg,jun,2016,cons
Consultas psicológicas,36568,5858,42426,mg,dez,2017,cons
Consultas psicológicas,44714,4808,49522,mg,jun,2017,cons
Consultas psicológicas,25873,5877,31750,mg,dez,2018,cons
Consultas psicológicas,25089,3090,28179,mg,jun,2018,cons
Consultas psicológicas,25654,3775,29429,mg,dez,2019,cons
Consultas psicológicas,32487,3392,35879,mg,jun,2019,cons
Consultas psicológicas,29709,2211,31920,mg,dez,2020,cons
Consultas psicológicas,22437,2496,24933,mg,jun,2020,cons
Consultas psicológicas,5429,755,6184,ms,dez,2014,cons
Consultas psicológicas,2023,1751,3774,ms,jun,2014,cons
Consultas psicológicas,7759,3562,11321,ms,dez,2015,cons
Consultas psicológicas,4339,804,5143,ms,dez,2016,cons
Consultas psicológicas,4294,1156,5450,ms,jun,2016,cons
Consultas psicológicas,3741,1021,4762,ms,dez,2017,cons
Consultas psicológicas,4495,538,5033,ms,jun,2017,cons
Consultas psicológicas,5898,396,6294,ms,dez,2018,cons
Consultas psicológicas,5427,404,5831,ms,jun,2018,cons
Consultas psicológicas,8620,1535,10155,ms,dez,2019,cons
Consultas psicológicas,4722,1483,6205,ms,jun,2019,cons
Consultas psicológicas,3193,1141,4334,ms,dez,2020,cons
Consultas psicológicas,5629,615,6244,ms,jun,2020,cons
Consultas psicológicas,2216,306,2522,mt,dez,2014,cons
Consultas psicológicas,796,330,1126,mt,jun,2014,cons
Consultas psicológicas,2942,1190,4132,mt,dez,2015,cons
Consultas psicológicas,3357,95,3452,mt,dez,2016,cons
Consultas psicológicas,2407,700,3107,mt,jun,2016,cons
Consultas psicológicas,1752,401,2153,mt,dez,2017,cons
Consultas psicológicas,1982,126,2108,mt,jun,2017,cons
Consultas psicológicas,2407,1048,3455,mt,dez,2018,cons
Consultas psicológicas,2933,748,3681,mt,jun,2018,cons
Consultas psicológicas,8154,726,8880,mt,dez,2019,cons
Consultas psicológicas,4639,737,5376,mt,jun,2019,cons
Consultas psicológicas,2821,708,3529,mt,dez,2020,cons
Consultas psicológicas,2757,652,3409,mt,jun,2020,cons
Consultas psicológicas,5104,1102,6206,pa,dez,2014,cons
Consultas psicológicas,8582,1377,9959,pa,jun,2014,cons
Consultas psicológicas,17448,1544,18992,pa,dez,2015,cons
Consultas psicológicas,10862,1513,12375,pa,dez,2016,cons
Consultas psicológicas,12173,724,12897,pa,jun,2016,cons
Consultas psicológicas,8450,386,8836,pa,dez,2017,cons
Consultas psicológicas,8432,448,8880,pa,jun,2017,cons
Consultas psicológicas,7087,1225,8312,pa,dez,2018,cons
Consultas psicológicas,7593,542,8135,pa,jun,2018,cons
Consultas psicológicas,6448,1319,7767,pa,dez,2019,cons
Consultas psicológicas,9053,1370,10423,pa,jun,2019,cons
Consultas psicológicas,7214,515,7729,pa,dez,2020,cons
Consultas psicológicas,11956,804,12760,pa,jun,2020,cons
Consultas psicológicas,3593,401,3994,pb,dez,2014,cons
Consultas psicológicas,2282,176,2458,pb,jun,2014,cons
Consultas psicológicas,8810,928,9738,pb,dez,2015,cons
Consultas psicológicas,3432,150,3582,pb,dez,2016,cons
Consultas psicológicas,3942,197,4139,pb,jun,2016,cons
Consultas psicológicas,2147,1498,3645,pb,dez,2017,cons
Consultas psicológicas,2005,687,2692,pb,jun,2017,cons
Consultas psicológicas,3329,421,3750,pb,dez,2018,cons
Consultas psicológicas,2984,395,3379,pb,jun,2018,cons
Consultas psicológicas,5484,569,6053,pb,dez,2019,cons
Consultas psicológicas,4430,427,4857,pb,jun,2019,cons
Consultas psicológicas,4906,1147,6053,pb,dez,2020,cons
Consultas psicológicas,4779,795,5574,pb,jun,2020,cons
Consultas psicológicas,18622,1296,19918,pe,dez,2014,cons
Consultas psicológicas,17467,320,17787,pe,jun,2014,cons
Consultas psicológicas,30193,2119,32312,pe,dez,2015,cons
Consultas psicológicas,12501,1660,14161,pe,dez,2016,cons
Consultas psicológicas,17554,1055,18609,pe,jun,2016,cons
Consultas psicológicas,13980,1622,15602,pe,dez,2017,cons
Consultas psicológicas,8760,2094,10854,pe,jun,2017,cons
Consultas psicológicas,15555,2437,17992,pe,dez,2018,cons
Consultas psicológicas,11804,1679,13483,pe,jun,2018,cons
Consultas psicológicas,21422,3180,24602,pe,dez,2019,cons
Consultas psicológicas,13970,1968,15938,pe,jun,2019,cons
Consultas psicológicas,19949,996,20945,pe,dez,2020,cons
Consultas psicológicas,18095,2205,20300,pe,jun,2020,cons
Consultas psicológicas,564,136,700,pi,dez,2014,cons
Consultas psicológicas,300,44,344,pi,jun,2014,cons
Consultas psicológicas,2064,542,2606,pi,dez,2015,cons
Consultas psicológicas,663,152,815,pi,dez,2016,cons
Consultas psicológicas,983,188,1171,pi,jun,2016,cons
Consultas psicológicas,651,0,651,pi,dez,2017,cons
Consultas psicológicas,209,312,521,pi,jun,2017,cons
Consultas psicológicas,779,286,1065,pi,dez,2018,cons
Consultas psicológicas,337,150,487,pi,jun,2018,cons
Consultas psicológicas,985,430,1415,pi,dez,2019,cons
Consultas psicológicas,966,82,1048,pi,jun,2019,cons
Consultas psicológicas,1536,356,1892,pi,dez,2020,cons
Consultas psicológicas,1422,273,1695,pi,jun,2020,cons
Consultas psicológicas,6396,35,6431,pr,dez,2014,cons
Consultas psicológicas,7042,303,7345,pr,jun,2014,cons
Consultas psicológicas,6414,369,6783,pr,dez,2015,cons
Consultas psicológicas,4524,27,4551,pr,dez,2016,cons
Consultas psicológicas,3420,566,3986,pr,jun,2016,cons
Consultas psicológicas,4873,154,5027,pr,dez,2017,cons
Consultas psicológicas,5969,44,6013,pr,jun,2017,cons
Consultas psicológicas,3973,132,4105,pr,dez,2018,cons
Consultas psicológicas,4317,149,4466,pr,jun,2018,cons
Consultas psicológicas,3763,143,3906,pr,dez,2019,cons
Consultas psicológicas,3948,196,4144,pr,jun,2019,cons
Consultas psicológicas,3139,498,3637,pr,dez,2020,cons
Consultas psicológicas,3160,444,3604,pr,jun,2020,cons
Consultas psicológicas,14987,1196,16183,rj,dez,2014,cons
Consultas psicológicas,0,0,0,rj,jun,2014,cons
Consultas psicológicas,0,0,0,rj,dez,2015,cons
Consultas psicológicas,12001,3646,15647,rj,dez,2016,cons
Consultas psicológicas,0,0,0,rj,jun,2016,cons
Consultas psicológicas,11042,2527,13569,rj,dez,2017,cons
Consultas psicológicas,5842,2220,8062,rj,jun,2017,cons
Consultas psicológicas,5632,1179,6811,rj,dez,2018,cons
Consultas psicológicas,5844,1215,7059,rj,jun,2018,cons
Consultas psicológicas,5475,1856,7331,rj,dez,2019,cons
Consultas psicológicas,5687,1065,6752,rj,jun,2019,cons
Consultas psicológicas,2237,826,3063,rj,dez,2020,cons
Consultas psicológicas,1152,35,1187,rj,jun,2020,cons
Consultas psicológicas,207,24,231,rn,dez,2014,cons
Consultas psicológicas,80,33,113,rn,jun,2014,cons
Consultas psicológicas,215,12,227,rn,dez,2015,cons
Consultas psicológicas,346,9,355,rn,dez,2016,cons
Consultas psicológicas,214,24,238,rn,jun,2016,cons
Consultas psicológicas,788,25,813,rn,dez,2017,cons
Consultas psicológicas,333,67,400,rn,jun,2017,cons
Consultas psicológicas,238,110,348,rn,dez,2018,cons
Consultas psicológicas,94,23,117,rn,jun,2018,cons
Consultas psicológicas,2080,153,2233,rn,dez,2019,cons
Consultas psicológicas,508,138,646,rn,jun,2019,cons
Consultas psicológicas,4609,191,4800,rn,dez,2020,cons
Consultas psicológicas,991,102,1093,rn,jun,2020,cons
Consultas psicológicas,567,120,687,ro,dez,2014,cons
Consultas psicológicas,445,89,534,ro,jun,2014,cons
Consultas psicológicas,307,33,340,ro,dez,2015,cons
Consultas psicológicas,208,38,246,ro,dez,2016,cons
Consultas psicológicas,180,36,216,ro,jun,2016,cons
Consultas psicológicas,277,108,385,ro,dez,2017,cons
Consultas psicológicas,295,83,378,ro,jun,2017,cons
Consultas psicológicas,769,137,906,ro,dez,2018,cons
Consultas psicológicas,1098,290,1388,ro,dez,2019,cons
Consultas psicológicas,1192,502,1694,ro,jun,2019,cons
Consultas psicológicas,327,443,770,ro,dez,2020,cons
Consultas psicológicas,430,406,836,ro,jun,2020,cons
Consultas psicológicas,21,192,213,rr,dez,2014,cons
Consultas psicológicas,21,192,213,rr,jun,2014,cons
Consultas psicológicas,11,0,11,rr,dez,2015,cons
Consultas psicológicas,0,0,0,rr,dez,2016,cons
Consultas psicológicas,59,20,79,rr,jun,2016,cons
Consultas psicológicas,0,45,45,rr,dez,2017,cons
Consultas psicológicas,0,51,51,rr,jun,2017,cons
Consultas psicológicas,6,144,0,rr,dez,2018,cons
Consultas psicológicas,2,120,122,rr,jun,2018,cons
Consultas psicológicas,228,80,308,rr,dez,2019,cons
Consultas psicológicas,259,0,259,rr,jun,2019,cons
Consultas psicológicas,788,313,1101,rr,dez,2020,cons
Consultas psicológicas,163,256,419,rr,jun,2020,cons
Consultas psicológicas,9816,1182,10998,rs,dez,2014,cons
Consultas psicológicas,15729,1067,16796,rs,jun,2014,cons
Consultas psicológicas,23778,4223,28001,rs,dez,2015,cons
Consultas psicológicas,23080,4553,27633,rs,dez,2016,cons
Consultas psicológicas,18098,3912,22010,rs,jun,2016,cons
Consultas psicológicas,30822,4177,34999,rs,dez,2017,cons
Consultas psicológicas,23214,4340,27554,rs,jun,2017,cons
Consultas psicológicas,25801,4098,29899,rs,dez,2018,cons
Consultas psicológicas,6506,1127,7633,rs,jun,2018,cons
Consultas psicológicas,32624,5015,37639,rs,dez,2019,cons
Consultas psicológicas,26622,4389,31011,rs,jun,2019,cons
Consultas psicológicas,37346,4127,41473,rs,dez,2020,cons
Consultas psicológicas,30742,4129,34871,rs,jun,2020,cons
Consultas psicológicas,10925,513,11438,sc,dez,2014,cons
Consultas psicológicas,7586,442,8028,sc,jun,2014,cons
Consultas psicológicas,16835,972,17807,sc,dez,2015,cons
Consultas psicológicas,8960,367,9327,sc,dez,2016,cons
Consultas psicológicas,10219,659,10878,sc,jun,2016,cons
Consultas psicológicas,12032,841,12873,sc,dez,2017,cons
Consultas psicológicas,9502,615,10117,sc,jun,2017,cons
Consultas psicológicas,10111,892,11003,sc,dez,2018,cons
Consultas psicológicas,11207,492,11699,sc,jun,2018,cons
Consultas psicológicas,11717,2075,13792,sc,dez,2019,cons
Consultas psicológicas,8563,1508,10071,sc,jun,2019,cons
Consultas psicológicas,11122,1455,12577,sc,dez,2020,cons
Consultas psicológicas,11283,3235,14518,sc,jun,2020,cons
Consultas psicológicas,2670,0,2670,se,dez,2014,cons
Consultas psicológicas,859,0,859,se,jun,2014,cons
Consultas psicológicas,1622,0,1622,se,dez,2015,cons
Consultas psicológicas,2921,57,2978,se,dez,2016,cons
Consultas psicológicas,1981,0,1981,se,jun,2016,cons
Consultas psicológicas,5736,36,5772,se,dez,2017,cons
Consultas psicológicas,4023,24,4047,se,jun,2017,cons
Consultas psicológicas,5415,286,5701,se,dez,2018,cons
Consultas psicológicas,5596,333,5929,se,jun,2018,cons
Consultas psicológicas,4191,52,4243,se,dez,2019,cons
Consultas psicológicas,5760,116,5876,se,jun,2019,cons
Consultas psicológicas,1114,92,1206,se,dez,2020,cons
Consultas psicológicas,3980,127,4107,se,jun,2020,cons
Consultas psicológicas,72464,7250,79714,sp,dez,2014,cons
Consultas psicológicas,NI,NI,NI,sp,jun,2014,cons
Consultas psicológicas,121075,10035,131110,sp,dez,2015,cons
Consultas psicológicas,75438,6383,81821,sp,dez,2016,cons
Consultas psicológicas,65128,6108,71236,sp,jun,2016,cons
Consultas psicológicas,64275,7547,71822,sp,dez,2017,cons
Consultas psicológicas,64734,8059,72793,sp,jun,2017,cons
Consultas psicológicas,51869,7431,59300,sp,dez,2018,cons
Consultas psicológicas,57581,5076,62657,sp,jun,2018,cons
Consultas psicológicas,61225,8711,69936,sp,dez,2019,cons
Consultas psicológicas,51587,8143,59730,sp,jun,2019,cons
Consultas psicológicas,42813,4740,47553,sp,dez,2020,cons
Consultas psicológicas,38188,5890,44078,sp,jun,2020,cons
Consultas psicológicas,713,69,782,to,dez,2014,cons
Consultas psicológicas,1203,30,1233,to,jun,2014,cons
Consultas psicológicas,2523,171,2694,to,dez,2015,cons
Consultas psicológicas,979,20,999,to,dez,2016,cons
Consultas psicológicas,1680,39,1719,to,jun,2016,cons
Consultas psicológicas,1176,22,1198,to,dez,2017,cons
Consultas psicológicas,275,10,285,to,jun,2017,cons
Consultas psicológicas,883,6,889,to,dez,2018,cons
Consultas psicológicas,923,12,935,to,jun,2018,cons
Consultas psicológicas,1120,50,1170,to,dez,2019,cons
Consultas psicológicas,705,193,898,to,jun,2019,cons
Consultas psicológicas,695,127,822,to,dez,2020,cons
Consultas psicológicas,811,99,910,to,jun,2020,cons
